

NO ./textures/Chucky.xpm
SO ./textures/Scoobie.xpm
EA ./textures/Saw.xpm
WE ./textures/Scream.xpm

F 142  , 142 , 142
C 83 , 15 , 10

1111111111111111
1010000000000001
1010000100000111
1010000000010001
1000E00000010001
1111111111111111
