

NO ./textures/Champ.xpm
SO ./textures/Chomp.xpm
EA ./textures/wood.xpm
WE ./textures/greystone.xpm


F 0  , 0, 50
C 133 , 6 , 6

1111111111111111
10100000W0000001
1111111111111111
