C 133, 6 ,6

NO ./textures/colorstone.xpm
SO ./textures/greystone.xpm
EA ./textures/redbrick.xpm
WE ./textures/purplestone.xpm

F  190, 120, 230



111111111111111111111111111111111111111111111111
111111111000100000000000011111000000000000000001
100000000000000000111000100001000001010101010001
110000100000000000000000001111000000000000000001
100001111111000000010000111111000000000000010001
111111100000000000000000000000000000000000000001
11110000000000110000000100000W000000000000010001
100000000000000000000000000000000000000000000001   
110000000000011110000000000011000000000000010001
100000000000111000000000000011110000000000000001
110000000000111000000000001111000001010101010001
110000000001111000000000000111000000000000000001
111111111111111111111111111111111111111111111111
